00000030000300000001
00040030000400404001
00040030004400434001
10000000000001400000
11000000000001300000
00001100000000200000
12222000400000200004
00010000400000200004
01010011122000000004
01000000004444000001
02000000000000014222
01004434400000010001
01000000000444014000
14444433100040004004
00000000100040004004
22200000000000434033
00000000000000000000
33340000444400000000
00040000455400004040
00040000455400004440