00000000400400000000
00400400400400400400
00444400444400444400
00000000000000000000
00000400444400400000
33300400400400400333
44400400400400400444
00400400444400400400
00000000000000000000
00004444444444444000
00000000000000000000
44444400444400444444
04000000400400000040
04000044444444000040
04000000000000000040
00000000000000000000
44444400000000444444
00040000444400004000
00040000455400004000
00000000455400000000